111111111111111
111111111111111
110011111111111
100001111111111
110011111111111
111111111111111
111111111111111
111111111111111
111111111111111
111111111111111